    A    B  C  D  E  F  G  H  I  J  K
   ______________________________________
1 |PssGO|  |  |  |  |  |  |  |  |  | Jail| 1
  |LndGo|__|__|__|__|__|__|__|__|__|_J.V.| 
2 |_____|                          |_____| 2
3 |_____|                          |_____| 3
4 |_____|                          |_____| 4
5 |_____|   CLASSIC UK EDITION     |_____| 5
6 |_____|    10 x 9                |_____| 6
7 |_____|                          |_____| 7
8 |_____|__________________________|_____| 8
9 |Go to|  |  |  |  |  |  |  |  |  | Free| 9
  |_Jail|__|__|__|__|__|__|__|__|__|_Park|

SNAKES & LADDERS - India - Map
   I        H        G         F        E       D       C        B       A
  ______________________________________________________________________________
15|140    ||8       ||7      ||6     ||5      ||4    ||3      ||2      ||1      |
  |  [ ]  ||  [ ]  ||  [ ]  ||  [ ]  ||  [ ]  || [X] ||  [ ]  ||  [ ]  ||  [ ]  |
  |_______||_______||_______||_______||_______||_____||_______||_______||_______|
14|130    ||18     ||17     ||16     ||15     ||14   ||13     ||12     ||10     |
  |  [ ]  ||  [ ]  ||  [ ]  ||  [ ]  ||  [ ]  || [X] ||  [ ]  ||  [ ]  ||  [ ]  |
  |_______||_______||_______||_______||_______||_____||_______||_______||_______|
13|120      ||8       ||7      ||6     ||5      ||4    ||3      ||2      ||1      |
  |  [ ]  ||  [ ]  ||  [ ]  ||  [ ]  ||  [ ]  || [X] ||  [ ]  ||  [ ]  ||  [ ]  |
  |_______||_______||_______||_______||_______||_____||_______||_______||_______|
12|110      ||8       ||7      ||6     ||5      ||4    ||3      ||2      ||1      |
  |  [ ]  ||  [ ]  ||  [ ]  ||  [ ]  ||  [ ]  || [X] ||  [ ]  ||  [ ]  ||  [ ]  |
  |_______||_______||_______||_______||_______||_____||_______||_______||_______|
11|100     ||18     ||17     ||16     ||15     ||14   ||13     ||12     ||10     |
  |  [ ]  ||  [ ]  ||  [ ]  ||  [ ]  ||  [ ]  || [X] ||  [ ]  ||  [ ]  ||  [ ]  |
  |_______||_______||_______||_______||_______||_____||_______||_______||_______|
10|90      ||8       ||7      ||6     ||5      ||4    ||3      ||2      ||1      |
  |  [ ]  ||  [ ]  ||  [ ]  ||  [ ]  ||  [ ]  || [X] ||  [ ]  ||  [ ]  ||  [ ]  |
  |_______||_______||_______||_______||_______||_____||_______||_______||_______|
 9|89      ||8       ||7      ||6     ||5      ||4    ||3      ||2      ||1      |
  |  [ ]  ||  [ ]  ||  [ ]  ||  [ ]  ||  [ ]  || [X] ||  [ ]  ||  [ ]  ||  [ ]  |
  |_______||_______||_______||_______||_______||_____||_______||_______||_______|
 8|79     ||18     ||17     ||16     ||15     ||14   ||13     ||12     ||10     |
  |  [ ]  ||  [ ]  ||  [ ]  ||  [ ]  ||  [ ]  || [X] ||  [ ]  ||  [ ]  ||  [ ]  |
  |_______||_______||_______||_______||_______||_____||_______||_______||_______|
 7|69      ||8       ||7      ||6     ||5      ||4    ||3      ||2      ||1      |
  |  [ ]  ||  [ ]  ||  [ ]  ||  [ ]  ||  [ ]  || [X] ||  [ ]  ||  [ ]  ||  [ ]  |
  |_______||_______||_______||_______||_______||_____||_______||_______||_______|
 6|59      ||8       ||7      ||6     ||5      ||4    ||3      ||2      ||1      |
  |  [ ]  ||  [ ]  ||  [ ]  ||  [ ]  ||  [ ]  || [X] ||  [ ]  ||  [ ]  ||  [ ]  |
  |_______||_______||_______||_______||_______||_____||_______||_______||_______|
 5|49     ||18     ||17     ||16     ||15     ||14   ||13     ||12     ||10     |
  |_______||_______||_______||_______||_______||_____||_______||_______||_______|
 4|39      ||8       ||7      ||6     ||5      ||4    ||3      ||2      ||1      |
  |  [ ]  ||  [ ]  ||  [ ]  ||  [ ]  ||  [ ]  || [X] ||  [ ]  ||  [ ]  ||  [ ]  |
  |_______||_______||_______||_______||_______||_____||_______||_______||_______|
 3|29      ||8       ||7      ||6     ||5      ||4    ||3      ||2      ||1      |
  |  [ ]  ||  [ ]  ||  [ ]  ||  [ ]  ||  [ ]  || [X] ||  [ ]  ||  [ ]  ||  [ ]  |
  |_______||_______||_______||_______||_______||_____||_______||_______||_______|
 2|  [ ]  ||  [ ]  ||  [ ]  ||  [ ]  ||  [ ]  || [X] ||  [ ]  ||  [ ]  ||  [ ]  |
  |19     ||18     ||17     ||16     ||15     ||14   ||13     ||12     ||10     |
  |_______||_______||_______||_______||_______||_____||_______||_______||_______|
 1|9      ||8       ||7      ||6     ||5      ||4    ||3      ||2      ||1      |
  |  [ ]  ||  [ ]  ||  [ ]  ||  [ ]  ||  [ ]  || [X] ||  [ ]  ||  [ ]  ||  [ ]  |
  |_______||_______||_______||_______||_______||_____||_______||_______||_______|
   A       B       C        D       E         F      G        H        I

Properties: any pieces on the board except special...?
Random card: ?? 
Special spaces: Start: 1, Finish: 141, ..., ..., ...  Railroads: (SPECIAL LOCATIONS ON THE BOARD) A5, E10, I5, E1
Must land on the square to use:
  - Ladders 2 - 14, 
  - Snakes: 4 - 2,

